0000000000000000000000000000000000000000000000000000000000000000000000000000000000000000000000000000
0000000000000000000000000000000000000000000000000000000000000000000000000000000000000000000000000000
0000000000000000000000000000000000000000000000000000000000000000000000000000000000000000000000000000
0000000000000000000000000000000000000000000000000000000000000000000000000000000000000000000000000000
0000000000000000000000000000000000000000000000000000000000000000000000000000000000000000000000000000
0000000000000000000000000000000000000000000000000000000000000000000000000000000000000000000000000000
0000000000000000000000000000000000000000000000000000000000000000000000000000000000000000000000000000
0000000000000000000000000000000000000000000000000000000000000000000000000000000000000000000000000000
0000000000000000000000000000000000000000000000000000000000000000000000000000000000000000000000000000
0000000000000000000000000000000000000000000000000000000000000000000000000000000000000000000000000000
00000000000000000000000000X0000000000000000000000000000000000000000000000000000000000000000000000000
00000000X0000000000000000000000000000000000000000000000000000000000000000000000000000000000000000000
0000000000000000000000000000000000000000X0000000000000000000000000000000000000000000000000X000000000
00000000000000000000000000000000000000000000000000000000000000000000000000X0000000000000000000000000
0000000000000000000000000000000000000000000000000000000000000000000000000000000000000000000000000000
00000000000000000000XX00000000000000000000000E00000X0000000000000X0000000000000000000000000000000000
000000000000000000000000000000000000000000000000000000000000000000000000000000000000000E000000000000
00S000000000000000000000000000000000000000VVVVVVV00000000000000000000000000000000000000000000VVVVVVV
000000000000VVVV00000000E000000000VVVVVVVVVIIIIIVVV00000000000E00000E00000000000000VVVVVVVVVVVIIIIII
0000000000VVVIIVVVVV00000000VVVVVVVIIIIIIIIIIIIIIIVVVVVVV00000000000000000VVVVVVVVVVIIIIIIIIIIIIIIII
VVVVVVVVVVVIIIIIIIIVVVVVVVVVIIIIIIIIIIIIIIIIIIIIIIIIIIIIVVVVVVVVVVVVVVVVVVVIIIIIIIIIIIIIIIIIIIIIIIII
IIIIIIIIIIIIIIIIIIIIIIIIIIIIIIIIIIIIIIIIIIIIIIIIIIIIIIIIIIIIIIIIIIIIIIIIIIIIIIIIIIIIIIIIIIIIIIIIIIII
IIIIIIIIIIIIIIIIIIIIIIIIIIIIIIIIIIIIIIIIIIIIIIIIIIIIIIIIIIIIIIIIIIIIIIIIIIIIIIIIIIIIIIIIIIIIIIIIIIII
IIIIIIIIIIIIIIIIIIIIIIIIIIIIIIIIIIIIIIIIIIIIIIIIIIIIIIIIIIIIIIIIIIIIIIIIIIIIIIIIIIIIIIIIIIIIIIIIIIII
IIIIIIIIIIIIIIIIIIIIIIIIIIIIIIIIIIIIIIIIIIIIIIIIIIIIIIIIIIIIIIIIIIIIIIIIIIIIIIIIIIIIIIIIIIIIIIIIIIII